....................
....................
....................
....................
....................
....................
.................##.
...........#........
....................
.......0............
.......#............
......##............
.....###............
....####.........0.#
####################