....................
....................
....................
....................
....................
....................
.................##.
....................
....................
.......0............
.......#............
......##...#.#......
.....###...#.#......
....####...#.#...0.#
####################