....................
....................
....................
....................
....................
....................
.................##.
............##......
....................
....................
....................
.......0............
.....###............
########.........0.#
########...#########
