....................
....................
....................
....................
....................
....................
.................##.
............##......
....................
....................
....................
....................
.....###............
....####.........0.#
########...#########
