....................
....................
....................
....................
....................
....................
....................
....................
....................
....................
....................
....................
....................
##..........0....0..
####################
