....................
....................
....................
....................
....................
....................
....................
....................
....................
....................
....................
....................
....................
............0....0..
####################
