00000000000000000000
00000000000000000000
00000000000000000000
............00000000
....................
....................
.............0000000
........00000000....
....................
....................
....................
....................
....................
...00000000000000000
####################